*************
*.*.*.*.*.*.*
*.*.*.*.*.*.*
*.......*...*
*.*..*......*
*.......*...*
*************
